! 2 = TileDirt
! 1 = TileOcean
2          2
2          2
2          2
2          2
2          2
2          2
2          2
2          2
2          2
2          2
2          2
2          2
21         2
221        2
21         2
2         22
2        222
2         22
2          2
2     5    2
2          2
2          2
2          2
2          2
2          2
2          2
2          2
2          2
2          2
2          2
2          2
2          2
2          2
2          2
2          2
2          2
2          2
2         22
2        222
2        222
2        222
2        222
22        22
22        22
222        2
222        2
2222       2
222      222
222     2222
22      2222
2      22222
25       222
21        22
211        2
2111    5  2
211111    12
211111    12
211111    12
2111       2
211        2
211     1112
21    111112
2       1112
2          2
2       5  2
2          2
2  5       2
2          2
2          2
2         22
2          2
2    5     2
2          2
21         2
211    5   2
21         2
2          2
2          2
2          2
2          2
2          2
2      5  22
2        222
2        222
2         22
2          2
2          2
2          2
2          2
2          2
2          2
2          2
2          2
2          2
2          2
2          2
2          2
2          2
2          2
2          2
2          2
2          2
2          2
2          2
2          2
2          2
2          2
2          2
211111111112
211111111112
211111111112
211111111112
222222222222
222222222222
222222222222
222222222222
222222222222
222222222222


  4      4




    4




     4



  4




   4  4  4



   4